1111111111111111111111
1S00101111101110101111
1000101111111111111011
1000000P00000000001111
1011101011111C10111011
1111111011101010C11011
1000111011111010111011
1010101011111110101011
1110111010001C10111011
10000000001010000000E1
1111111111111111111111