111111111111
1P100C110001
1010101C0101
101010010101
10C011010101
110100010101
11C10111S101
1001000001E1
1C1111111111
111111111111
