1111111111111111111111111111
10000000000000000000000000E1
10011100011110001111001110S1
1001C100000C100000C1001C1001
1000010000111000011100001001
10000100000C100000C100001001
1000111001111000111100001001
1P00000000000000000000000001
1111111111111111111111111111