1111111
100PD01
1EC0111
1111111